0000011110
1111110010
1002002510
1000110010
1001330110
1121332010
1101330010
1000110010
1002002010
1111110010
0000011110
0000000000
