0001111000
0111001000
0100001100
1121000100
1001210111
1020343001
1051113101
1101333201
0100212111
0110000100
0011111100
0000000000
