0000000000
0000000000
0001111110
0111000010
1130211011
1332020051
1330202011
1111110010
0000011110
0000000000
0000000000
0000000000
