0000000000
0000000000
0001111110
1111300510
1002220010
1311311310
1000200010
1002310110
1111000100
0001111100
0000000000
0000000000
