0000111110
0000100010
0111120010
0133020010
0133200110
0133102100
0103120110
0111102010
0001020010
0001005010
0001111110
0000000000
