1111111110
1000100010
1010002010
1010112110
1333320010
1133010010
0112110111
0100000201
0100012101
0111110051
0000011111
0000000000
