0000000000
0000000000
0001111000
0001331000
0011031100
0010023100
0110200110
0100122010
0100500010
0111111110
0000000000
0000000000
