0000000000
0000000000
0011111100
0013033100
0013023100
0111002110
0102002010
0101211010
0100050010
0111111110
0000000000
0000000000
