0000000000
0000000000
0001111100
0001050100
0001222100
1111000100
1000312110
1023230310
1001313110
1111111100
0000000000
0000000000
