0000001111
0000111051
1111100001
1020331201
1001332001
1021001201
1002331001
1021330201
1000011111
1001110000
1111000000
0000000000
