0000000000
0000000000
0001110000
0001310000
0001011110
0111202310
0130251110
0111121000
0000131000
0000111000
0000000000
0000000000
