0000000000
0000000000
0111111110
0100100010
0103332010
0150220110
0104432010
0100100010
0111111110
0000000000
0000000000
0000000000
