0000000000
0000000000
0000011111
0111110001
0103302101
0101340001
1104312011
1020020010
1000110510
1111111110
0000000000
0000000000
