0000000000
0011111100
0010000111
0010200001
1110201101
1333020001
1333212011
1111010201
0001005001
0001111111
0000000000
0000000000
