0000000000
0000000000
0001111111
0011001051
0010001001
0012020201
0010211001
1110201011
1333330010
1111111111
0000000000
0000000000
