0000000000
0000000000
0011111000
0015011100
0010200100
0111010110
0131010010
0132001010
0130002010
0111111110
0000000000
0000000000
