0000000000
0000000000
1111110000
1000010000
1022211000
1001331110
1100332010
0105000010
0111111110
0000000000
0000000000
0000000000
